    Activity and Fragments=>RxRouter_&_Navigation_%_ssseasonnn/RxRouter___Inline Activity Results_&_Navigation_%_afollestad/inline-activity-result___CachePot_&_Navigation_%_kimkevin/CachePot___Medusa_&_Fragment Stack_%_Trendyol/medusa___Sliding Activity_&_Activity,Swipe_%_klinker41/android-slidingactivity___Slidr_&_Slide_%_r0adkll/Slidr___ActivitSwitcher_&_Navigation_%_Hitomis/ActivitySwitcher___Drag Dismiss Activity_&_Slide_%_klinker24/Android-DragDismissActivity___Custom Activity On Crash_&_Crash_%_Ereza/CustomActivityOnCrash___Sliding Activity_&_Slide_%_klinker41/android-slidingactivity___Swipe Back Layout_&_Slide_%_gongwen/SwipeBackLayout___Activity Starter_&_Navigation_%_MarcinMoskala/ActivityStarter___Floating Tutorial Activity_&_Pager_%_klinker24/Android-FloatingTutorialActivity___Drawing Activity_&_Drawing_%_ChilliBits/drawing-activity___Activity Fragment Manager_&_Activity,Fragment_%_massivedisaster/ActivityFragmentManager___FragmentRigger_&_Fragment_%_JingYeoh/FragmentRigger___Android Navigation_&_Navigation_%_listenzz/AndroidNavigation___FragNav_&_Fragment,Navigation_%_ncapdevi/FragNav___Fragment State Manager_&_Fragment,Navigation_%_okaybroda/FragmentStateManager___Fragment Navigation 2.0_&_Fragment,Navigation_%_gyorgygabor/fragment-navigation-2.0
    AppBar and Toolbar=>ScalingLayout_&_Layout_%_iammert/ScalingLayout___AppBar Sync FAB_&_AppBar,FAB_%_strooooke/appbarsyncedfab___Navigation ToolBar_&_ToolBar_%_Ramotion/navigation-toolbar-android___Toolbar Button_&_ToolBar_%_GautamGupta/toolbar-button___ToolBar Center Title_&_ToolBar_%_RaviKoradiya/Toolbar-Center-Title___Navigation Header_&_ToolBar,Animated_%_QArtur99/NavigationHeader___Smart ToolBar_&_ToolBar_%_Chivorns/SmartToolbar
    Animation=>TextSurface_&_TextView_%_elevenetc/TextSurface___Loading Images Animation_&_ImageView_%_Cutta/LoadingImagesAnimation___Bungee_&_Transition,Activity_%_Binary-Finery/Bungee___Animatoo_&_Transition,Activity_&_AtifSayings/Animatoo___Activity Circular Reveal_&_Activity,Reveal_%_tombayley/ActivityCircularReveal___Spruce Tree Android_&_Animations_%_willowtreeapps/spruce-android___ViewAnimator_&_Views_%_florent37/ViewAnimator___RecyclerView Animators_&_RecyclerView_%_wasabeef/recyclerview-animators___Garland View_&_Lists_%_Ramotion/garland-view-android___Slide Up_&_Slide,Views_%_mancj/SlideUp-Android___Android Particles_&_Particles_%_ibrahimsn98/android-particles___ViewPager Transforms_&_ViewPager_%_ToxicBakery/ViewPagerTransforms___PopView Android_&_View,Pop_%_krishnarb3/Popview-Android___Count Animation TextView_&_TextView,Count_%_MasayukiSuda/CountAnimationTextView___Frame Animation_&_Frame_%_yuyashuai/FrameAnimation___Reflow Animation_&_TextView_%_shazam/reflow-animator___Animated RecyclerView_&_RecyclerView_%_MLSDev/AnimatedRecyclerView___Transition Player_&_Transition_%_linfaxin/TransitionPlayer___Sticky Switch_&_Switch_%_GwonHyeok/StickySwitch___Spark_&_Gradient_%_TonnyL/Spark___Interactive canvas_&_Canvas_%_elevenetc/InteractiveCanvas___FAB Transitions_&_Floating Action Button_%_Adirockzz95/FABtransitions___Yava_&_View_%_javayhu/yava___Google News Stand Animation_&_Navigation_%_hariprasanths/GoogleNewsStandAnimation-Android___Reachability_&_Navigation_%_sakebook/Reachability___Sequent_&_Continous_%_fujiyuu75/Sequent___FPS Animator_&_TextureView,SurfaceView_%_MasayukiSuda/FPSAnimator___Android Animations Kotlin_&_General_%_gayanvoice/android-animations-kotlin___Disco_&_Scroll_%_m1noon/Disco
    Async and Multi-Threading=>Peanut_&_Multi-Threading_%_savepopulation/peanut___AsyncJobLibrary_&_Async_%_Arasthel/AsyncJobLibrary___AsyncManager_&_Async_%_boxme/AsyncManager___Advanced AsyncTask_&_Async_%_mcsong/AdvancedAsyncTask___Task Scheduler_&_Async_%_SilenceDut/TaskScheduler___Android Startup_&_Startup_%_idisfkj/android-startup___Sync_&_Async_%_leomindez/Sync___KillerTask_&_Async_%_inaka/KillerTask___Valuable_&_Async_%_dieyidezui/Valuable___Thread Poster_&_Multi-Threading_%_techyourchance/thread-poster
    Gallery=>Galleryna_&_Image Gallery_%_Oclemy/Galleryna___Banner-Slider_&_Slider_%_saeedsh92/Banner-Slider___SlideImageView_&_Slider_%_Devlight/SlideImageView___RecyclerView Gallery_&_Image Gallery,Animation_%_ryanlijianchang/Recyclerview-Gallery___ZGallery_&_Image Gallery_%_mzelzoghbi/ZGallery___CardStackLayoutManager_&_Stack_%_mayuroks/CardStackLayoutManager
    Biometric=>Assure_&_Biometric_%_afollestad/assure___Gold Finger_&_Biometric_%_infinum/Android-Goldfinger___Biometric Kit_&_Biometric_%_AlexJuca/BiometricKit___RxBiometric_&_Biometric_%_pwittchen/RxBiometric___Reprint_&_Biometric_%_ajalt/reprint___BioXLib_&_Biometric_%_Txagg1992/BioXLib___Biometric-Auth-Login_&_Authentication_%_thulasiram-sarathy/Biometric-Auth-Login___Android Biometric_&_Biometric_%_li2/android-biometric___Android-BiometricKit_&_Biometric_%_Sultan1993/Android-BiometricKit___SimpleBiometricHandler_&_Biometric_%_juhchamp/SimpleBiometricHandler
    OCR=>SimpleBarcodeScanner_&_Bar Code_%_bobekos/SimpleBarcodeScanner___Bar Code Scanner_&_Bar Code_%_dm77/barcodescanner___BarCodeScanView_&_Bar Code_%_anbillon/Android-BarCodeScanView
    Camera and File Pickers=>Android Image Cropper_&_Crop_%_ArthurHub/Android-Image-Cropper___Easy Image_&_Camera,Gallery,Videos,Documents_%_jkwiecien/EasyImage___PhotoPicker_&_Image Picker_%_liuling07/PhotoPicker___PickPhotoView_&_Image Picker_%_werbhelius/PickPhotoSample___ChiliPhotoPicker_&_Image Picker_%_ChiliLabs/ChiliPhotoPicker___Louvre_&_Image Picker_%_andremion/Louvre___Croppy_&_Crop_%_lyrebirdstudio/Croppy___MediaPickerKit_&_Runtime Permissions_%_karanatwal/MediaPickerKt___TedBottomPicker_&_Image Picker,Camera_%_ParkSangGwon/TedBottomPicker___UCrop_&_Crop_%_Yalantis/uCrop
    CardView=>Truffle Shuffle_&_List,Gallery,Animation_%_intuit/truffle-shuffle___BoardView_&_Drag Drop,Columns_%_jakebonk/BoardView
    Chips=>ChipsLayoutManager_&_Tags_%_BelooS/ChipsLayoutManager___TagView_&_Editable,Tags_%_Cutta/TagView___AndroidTagGroup_&_Cloud,Tags_%_2dxgujun/AndroidTagGroup___TagsEditText_&_Editable,Tags_%_mabbas007/TagsEditText___Android TagView_&_Events,Editable,Tags_%_whilu/AndroidTagView___3D Tag Cloud_&_3D_%_misakuo/3dTagCloudAndroid___ChipView_&_Editable_%_jakebonk/ChipView
    Date,Time and Calender=>CalenderView Toolbar_&_Calender,Toolbar_%_kleisauke/CompactCalendarViewToolbar___Compact CalenderView_&_Calendet_%_SundeepK/CompactCalendarView
    Bluetooth=>RxAndroid BLE_&_Reactive_%_Polidea/RxAndroidBle___Bluetooth Library_&_Bluetooth_%_OmarAflak/Bluetooth-Library___Fast BLE_&_Bluetooth_%_Jasonchenlijian/FastBle___RxBluetooth_&_Reactive_%_IvBaranov/RxBluetooth___ReactiveBeacons_&_Reactive_%_pwittchen/ReactiveBeacons___BluetoothHelper_&_Bluetooth_%_tlgbltcn/BluetoothHelper___Able_&_Bluetooth_%_JuulLabs/able___RxBluetoothKotlin_&_Reactive_%_VincentMasselis/RxBluetoothKotlin___AndroidBluetoothLibrary_&_Bluetooth_%_douglasjunior/AndroidBluetoothLibrary___Bluetoothkit-Android_&_Bluetooth_%_sirvar/bluetoothkit-android___Blueteeth_&_Bluetooth_%_RobotPajamas/Blueteeth___Easy BLE_&_Bluetooth_%_wandersnail/easyble___Blue Falcon_&_Bluetooth_%_Reedyuk/blue-falcon___LM Bluetooth SDK_%_Classic,Low Energy_%_whilu/LMBluetoothSdk
    Bottom Navigation=>BottomBar_&_Bottom Navigation_%_roughike/BottomBar___Readable BottomBar_&_Bottom Navigation_%_iammert/ReadableBottomBar
    Buttons=>Fabulous Filter_&_Floating Action Button_%_Krupen/FabulousFilter___RHSideButtons_&_Button_%_robertherdzik/RHSideButtons___Floating Action Button_&_Floating Action Button_%_msfjarvis/floating-action-button__FAB Reveal Menu_&_Floating Action Button_%_HarinTrivedi/FABRevealMenu-master___MaterialFabSpeedDial_&_Floating Action Button_%_kobakei/MaterialFabSpeedDial___FAB Transitions_&_Floating Action Button_%_Adirockzz95/FABtransitions___FAB Menu_&_Floating Action Button_%_cheekiat/FabMenu___Fabb_&_Floating Action Button_%_HBiSoft/Fabb___CameraVideoButton_&_Camera_%_iammert/CameraVideoButton___Spark Button_&_Animated,Heart_%_varunest/SparkButton
    Caching=>Reservoir_&_Disk Caching_%_anupcowkur/Reservoir___Fuse_&_Disk Caching_%_kittinunf/Fuse___DiskLruCache_&_Disk Caching_%_JakeWharton/DiskLruCache___LayerCache_&_Caching_%_appmattus/layercache___RxCache_&_Reactive_%_VictorAlbertos/RxCache___ObjectCache_&_Object Caching_%_iainconnor/ObjectCache___AndroidVideoCache_&_Video Caching_%_danikula/AndroidVideoCache__CacheUtilsLibrary_&_Caching_%_westlinkin/CacheUtilsLibrary___CacheLib_&_Caching_%_pcpl2/CacheLib___CacheManager_&_Caching_%_ronghao/CacheManage___mCache_&_Caching_%_diareuse/mCache___Store_&_Data Loading,Caching_%_dropbox/Store___Live Cache_&_LiveData,Caching_%_Mastercard/LiveCache___Bucket_&_Caching,Async_%_simonpercic/Bucket
    Chart=>MPAndroidChart_&_Charts_%_PhilJay/MPAndroidChart___Android Charts_&_Charts_%_HackPlan/AndroidCharts___Hello Charts_&_Charts_%_lecho/hellocharts-android
    Chat=>SimpleChatView_&_ChatView_%_ryanlijianchang/SimpleChatView
    Debugging and Logging=>Andzu_&_In App Debugging_%_isacan/Andzu___ShootOut_&_Logging_%_nisrulz/ShoutOut
    DiffUtil=>DiffAdapter_&_MultiView_%_SilenceDut/diffadapter
    Dialer=>Android Dialer_&_Dialer_%_dialogs/android-dialer___Android Dial Picker_&_Dialer_%_moldedbits/android-dial-picker
    Dialogs=>Material Dialogs_&_General Dialog_%_afollestad/material-dialogs___LovelyDialog_&_General Dialog_%_yarolegovich/LovelyDialog___Android MaterialDialog_&_General Dialog_%_michael-rapp/AndroidMaterialDialog___DialogPlus_&_General Dialog_%_orhanobut/dialogplus___Dialog_&_General Dialog_%_kongzue/DialogV3__Sweet Alert Dialog_&_Alert Dialog_%_pedant/sweet-alert-dialog___PrettyDialog_&_Alert Dialog_%_mjn1369/PrettyDialog___NiceDialog_&_Alert Dialog_%_SheHuan/NiceDialog___MaterialDialog-Android_&_General Dialog_%_PatilShreyas/MaterialDialog-Android___Android Tabbed Dialog_&_Tabbed Dialog_%_ashishbhandari/AndroidTabbedDialog___KAlertDialog_&_Alert Dialog_%_TutorialsAndroid/KAlertDialog___BlurDialogFragment_&_Blurred Dialog_%_tvbarthel/BlurDialogFragment___Flyco Dialog_&_Alert Dialog_%_H07000223/FlycoDialog_Master___StepDialog_&_Step Dialog_%_guangzq/StepDialog___Nifty Dialog Effects_&_Alert Dialog_%_sd6352051/NiftyDialogEffects___CanDialog_&_General Dialog_%_canyinghao/CanDialog__Android Ad Dialog_&_Ad Dialog_%_yipianfengye/android-adDialog___Android styled Dialogs_&_Alert Dialog_%_avast/android-styled-dialogs___EasyDialog_&_Alert Dialog_%_michaelye/EasyDialog___LicensesDialog_&_License Dialog_%_PSDev/LicensesDialog___SwipeAwayDialog_&_Alert Dialog_%_kakajika/SwipeAwayDialog___Search Dialog_&_Search Dialog_%_mirrajabi/search-dialog___NoInternetDialog_&_Alert Dialog_%_appwise-labs/NoInternetDialog___GDPRDialog_&_GDPR Dialog_%_MFlisar/GDPRDialog___Android-RateThisApp_&_Rating Dialog_%_kobakei/Android-RateThisApp___Calculator Dialog_&_Calculator Dialog_%_maltaisn/calcdialoglib
    Downloader=>Filebox_&_Async,Multi-Download_%_lyrebirdstudio/filebox
    Editor=>Rich Editor_&_Rich Editor_%_wasabeef/richeditor-android
    Email=>Email Intent Builder_&_Email,Intent_%_cketti/EmailIntentBuilder___Shelly_&_Email,Intent_%_jtribe/shelly___Maildroid_&_Email,SMTP_%_nedimf/maildroid
    Events=>EvTrack_&_Event Handling_%_nisrulz/EvTrack
    Expandables=>Expandable Layout_&_Layout_%_iammert/ExpandableLayout___Expanding View_&_Animated_%_diegodobelo/AndroidExpandingViewLibrary
    Firebase=>RxFirebase_&_Reactive_%_nmoskalenko/RxFirebase___FCM Notification Handler_&_Firebase Cloud Messaging_%_franmontiel/FcmNotificationHandler___FirePush_&_Firebase Cloud Messaging_%_karanatwal/FirePush___FCMHelper_&_Firebase Cloud Messaging_%_MOSDEV82/fcmhelper
    Framework=>Android UI Components_&_UI_%_Trendyol/android-ui-components___Clean UI_&_UI_%_JonathandelaSen/CleanUI
    Image Loader and Transformations=>Picasso_&_Image Loader_%_square/picasso___Glide_&_Image Loader_%_bumptech/glide___Android Universal ImageLoader_&_Image Loader_%_nostra13/Android-Universal-Image-Loader___Coil_&_Image Loader_%_coil-kt/coil___Glide Transformations_&_Image Transformations_%_wasabeef/glide-transformations___Transformers_&_Image Transformations_%_wasabeef/transformers___Composable Images_&_Jetpac Compose_%_wasabeef/composable-images
    ImageView=>Subsampling Scale ImageView_&_Zoom,Gesture,Animation,Efficiency_%_davemorrissey/subsampling-scale-image-view___GifView_&_Gifs_%_Cutta/GifView___Continous Scrollable ImageView_&_Animated_%_Cutta/ContinuousScrollableImageView___Simple Tag ImageView_&_Tag_%_wujingchao/SimpleTagImageView___Imaging_&_Image Edit_%_minetsh/Imaging___Image Zoomer_&_Zoom_%_code-crusher/Image-Zoomer___PanningView_&_Pan_%_andenapp/PanningView
    Intent=>Omega Intent Builder_&_Intent,Email,Share,Contact,Activity,Fragment_%_Omega-R/OmegaIntentBuilder___Intent Share_&_Share_%_tvbarthel/IntentShare___Data Auto Access_&_Extras_%_ThirtyDegreesRay/DataAutoAccess___Shelly_&_Intent,Email,Share,Contact_%_jtribe/shelly
    Intro and Showcase=>Material IntroView_&_Onboarding_%_iammert/MaterialIntroView___Showcase_&_Showcase_%_bilgehankalkan/showcase
    RecyclerView Item Animators=>RecyclerView Animators_&_Animations,RecyclerView_%_wasabeef/recyclerview-animators___Item Animators_&_Animations,RecyclerView_%_mikepenz/ItemAnimators
    Lock=>Pattern LockView_&_Pattern_%_aritraroy/PatternLockView___PinLockView_&_Pin_%_aritraroy/PinLockView
    Log=>Intent Logger_&_Intent_%_Drivemode/IntentLogger
    Maps and Location=>EasyMap_&_Google Maps_%_iammert/EasyMap___Smart Location Lib_&_Location_%_mrmans0n/smart-location-lib
    Markdown=>Markwon_&_Markdown_%_noties/Markwon
    Menu=>PopMenuLayout_&_Multi-Level_%_whilu/PopMenuLayout___Circle Menu_&_Animated_%_Hitomis/CircleMenu___GuillotineMenu_&_Circle Menu_%_Yalantis/GuillotineMenu-Android___Circle Menu Android_&_Circle Menu_%_Ramotion/circle-menu-android
    Music and Audio=>Interactive PlayerView_&_PlayerView_%_iammert/InteractivePlayerView___Radio Player Service_&_Radio_%_iammert/RadioPlayerService___Music Player View_&_PlayerView_%_iammert/MusicPlayerView
    Networking=>Retrofit_&_HTTP Client_%_square/retrofit___OkHTTP_&_HTTP Client_%_square/okhttp___Fuel_&_HTTP Client_%_kittinunf/fuel___Fast Android Networking_&_HTTP Client_%_amitshekhariitbhu/Fast-Android-Networking___Ion_&_HTTP Client_%_koush/ion___VolleyPlus_&_HTTP Client_%_DWorkS/VolleyPlus___Kalle_&_HTTP Client_%_yanzhenjie/Kalle___Tovuti_&_Networking_%_AndroidStudyOpenSource/tovuti___OptimusHTTP_&_HTTP Client_&_nisrulz/OptimusHTTP___AsyncNetwork_&_TCP,Async_%_OughtToPrevail/AsyncNetwork___Android Async_&_NIO,Socket_%_koush/AndroidAsync___Android HTTP Server_&_HTTP Server_%_matt1/AndroidHTTPServer
    NavigationView=>Material Drawer_&_Navigation Drawer_%_heinrichreimer/material-drawer___MaterialDrawer_&_Navigation Drawer_%_mikepenz/MaterialDrawer
    Notifications=>Alerter_&_In App_%_Tapadoo/Alerter___InfoView_&_In App,Old Fashioned_%_savepopulation/infoview___NotifyMe_&_Persistent,Time-Based_%_jakebonk/NotifyMe___PugNotification_&_Status Bar_%_halysongoncalves/Pugnotification___ShortcutBadger_&_Badge_%_leolin310148/ShortcutBadger___CookieBar_&_In App_%_AviranAbady/CookieBar2___Noty_&_In App_%_emre1512/Noty___Flashbar_&_In App_%_aritraroy/Flashbar___Minibar_&_In App_%_mayuroks/minibar
    Rating=>Easy Rating Dialog_&_Rating_%_fernandodev/easy-rating-dialog___Android-RateThisApp_&_Rating_%_kobakei/Android-RateThisApp___Feedback dialog_&_Feedback_%_shivasurya/FeedbackDialog_&_Smiley RatingBar_%_sujithkanna/SmileyRating
    REACTIVE PROGRAMMING=>RxJava3_&_RxJava_%_ReactiveX/RxJava___RxAndroid3_&_RxAndroid_%_ReactiveX/RxAndroid___RxJavaExtensions_&_RxJava_%_akarnokd/RxJavaExtensions___RxLibrary_&_RxJava_%_shanluwei/Rxlibrary___Roxie_&_Reactive Programming_%_ww-tech/roxie
    Permissions=>Assent_&_Runtime Permissions_%_afollestad/assent___Permy_&_Runtime Permissions_%_savepopulation/permy___Android Permissions_&_Runtime Permissions_%_nishkarsh/android-permissions
    Play Store=>RxMagneto_&_Play Store_%_aritraroy/RxMagneto
    Progress Indicator=>Stacked Horizontal ProgressBar_&_Dual Progress Bar_%_nisrulz/stackedhorizontalprogressbar___Progress Layout_&_Layout_%_iammert/ProgressLayout___Google ProgressBar_&_Google_%_jpardogo/GoogleProgressBar
    Packages=>Package Hunter_&_Package_%_nisrulz/packagehunter___AppListManager_&_Package,Activity_%_LayoutXML/AppListManager
    RecyclerView=>BaseRecyclerViewAdapterHelper_&_RecyclerView Adapter_%_CymChad/BaseRecyclerViewAdapterHelper___Flexible Adapter_&_RecyclerView Adapter_%_davideas/FlexibleAdapter___EasyAdapter_&_RecyclerView Adapter_%_mkrupal09/EasyAdapter___Fast Adapter_&_RecyclerView Adapter_%_mikepenz/FastAdapter___SectionedRecyclerViewAdapter_&_RecyclerView Adapter_%_SectionedRecyclerViewAdapter___Adapter_&_RecyclerView Adapter_%_thepacific/adapter___BindingCollectionAdapter_&_RecyclerView Adapter_%_evant/binding-collection-adapter___RendererRecyclerViewAdapter_&_RecyclerView Adapter_%_vivchar/RendererRecyclerViewAdapter___MultiViewAdapter_&_RecyclerView Adapter_%_DevAhamed/MultiViewAdapter___OneAdapter_&_RecyclerView Adapter_%_ironSource/OneAdapter___Smart Recycler Adapter_&_RecyclerView Adapter_%_manneohlund/smart-recycler-adapter___Items_&_RecyclerView Adapter_%_nekocode/Items___Fast List_&_RecyclerView Adapter_%_dev-labs-bg/fast-list___Pollux_&_RecyclerView Adapter_%_Oclemy/Pollux___Infinity_&_Pagination_%_Oclemy/Infinity___InfiniteScroll_&_Pagination_%_pwittchen/InfiniteScroll___DragSelectRecyclerView_&_Drag Drop_%_afollestad/drag-select-recyclerview___Recyclical_&_RecyclerView_%_afollestad/recyclical___RecyclerView FlexibleDivider_&_Divider_%_yqritc/RecyclerView-FlexibleDivider___Dividers_&_Divider_%_Karumi/Dividers__Y_DividerItemDecoration_&_Divider_%_yanyusong/Y_DividerItemDecoration___RecyclerView Divider_&_Divider_%_fondesa/recycler-view-divider___RecyclerViewHelper_&_Swipe,Drag Drop,Divider,Events_%_nisrulz/recyclerviewhelper___VegaLayoutManager_&_Layout Manager_%_xmuSistone/VegaLayoutManager___Generic RecyclerAdapter_&_Generic_%_burakeregar/GenericRecyclerAdapter___XRecyclerView_&_RecyclerView Adapter_%_XRecyclerView/XRecyclerView
    Screenshot=>Screenshott_&_Bitmap,File_%_nisrulz/screenshott
    Sensors=>ReactiveSensors_&_Reactive_%_pwittchen/ReactiveSensors___Sensey_&_Sensors_%_nisrulz/sensey___Easy Device Info_&_Info_%_nisrulz/easydeviceinfo
    SHARED PREFERENCES=>AndroidMaterialPreferences_&_Material_%_michael-rapp/AndroidMaterialPreferences___AndroidPreferenceActivity_&_Activity_%_michael-rapp/AndroidPreferenceActivity
    SearchView=>Floating SearchView_&_Floating_%_renaudcerrato/FloatingSearchView___MultiSearchView_&_Animated_%_iammert/MultiSearchView
    SeekBar and Ranges=>Material Range Bar_&_Multiple Uses_%_oli107/material-range-bar___RangeView_&_Range_%_iammert/RangeView___HueSeekBar_&_SeekBar_%_iammert/HueSeekBar
    Scroll=>Overscroll Decor_&_Scrolling_%_EverythingMe/overscroll-decor
    Tabs=>AnimatedTabLayout_&_Animated_%_iammert/AnimatedTabLayout___TabScrollAttacher_&_Categorization_%_iammert/TabScrollAttacher___SnapTabLayout_&_Tabs,Animated_%_nirukk52/SnapTabLayout
    TreeView=>DraggableTreeView_&_Drag Drop_%_jakebonk/DraggableTreeView
    RadioButtons=>Swipe Selector_&_roughike/SwipeSelector
    TextView=>ToolTipView_&_Tooltip_%_Cutta/ToolTipView
    URL=>Beaver_&_URL Parser,Cache_%_savepopulation/beaver
    Video Player=>AutoPlayVideos_&_AutoPlay_%_Krupen/AutoplayVideos___VideoPlayer Manager_&_List,MediaPlayer_%_danylovolokh/VideoPlayerManager
    Video=>Frames_&_Frames_%_iammert/Frames___Video MetaData Provider_&_Meta Data_%_iammert/VideoMetadataProvider
    Wifi=>ReactiveNetwork_&_Reactive_%_pwittchen/ReactiveNetwork___ReactiveWiFi_&_Reactive_%_pwittchen/ReactiveWiFi___Wifi-Connect_&_Connect_%_anitaa1990/Wifi-Connect___WifiUtils_&_Utils_%_ThanosFisherman/WifiUtils___Wroup_&_Wifi_%_ble180/Wroup
    Utilities=>AndroidUtilCode_&_General_%_Blankj/AndroidUtilCode___Android Development Utils_&_Info_%_SunPv5/AndroidDevelopmentUtils___Live Tools_&_LiveData_%_savepopulation/live-tools___Kotlin Ext_&_Kotlin_%_savepopulation/kotlin-ext___App Privacy Policy Generator_&_Web Tool_%_nisrulz/app-privacy-policy-generator___Upload To Bintray_&_Publish Library_%_nisrulz/UploadToBintray___Upload to Jitpack_&_Publish Library_%_nisrulz/UploadToJitpack___Upload to Maven Central_&_Publish Library_%_nisrulz/UploadToMavenCentral___Validateor_&_String,Validation_%_nisrulz/validatetor___Android Utils_&_General_%_nisrulz/android-utils___File Utils_&_File_%_coltoscosmin/FileUtils
