##Authentication
jsonwebtoken=>Keats/jsonwebtoken
jwtvault=>sgrust01/jwtvault
oauth2-rs=>ramosbugs/oauth2-rs
oxide-auth=>HeroicKatora/oxide-auth
yup-oauth2=>dermesser/yup-oauth2

##BioInformatics
pdbtbx=>nonnominandus/pdbtbx
rust-bio=>rust-bio

##Caching
sccache=>mozilla/sccache
bmemcached-rs=>jaysonsantos/bmemcached-rs
cached=>jaemk/cached
rust-memcache=>aisk/rust-memcache
hitbox=>hit-box/hitbox

##Client Side Web
sauron=>ivanceras/sauron
cargo-web=>koute/cargo-web
seed=>seed-rs/seed
stdweb=>koute/stdweb
yew=>yewstack/yew

##Cloud
rusoto=>rusoto/rusoto

##Cryptocurrencies
rust-sv=>brentongunning/rust-sv
cardano-cli=>input-output-hk/cardano-cli
ChainX=>chainx-org/ChainX
cita=>citahub/cita
coinbase-pro-rs=>inv2004/coinbase-pro-rs
ethaddrgen=>Limeth/ethaddrgen
forest=>ChainSafe/forest
grin=>mimblewimble/grin
hdwallet=>jjyr/hdwallet
holochain=>holochain/holochain
ibc-rs=>informalsystems/ibc-rs
bip39-rs=>infincia/bip39-rs
joystream=>Joystream/joystream
diem=>diem/diem
lighthouse=>sigp/lighthouse
nearcore=>near/nearcore
ckb=>nervosnetwork/ckb
core-rs=>nimiq/core-rs
parity-bitcoin=>paritytech/parity-bitcoin
parity-bridge=>paritytech/parity-bridge
openethereum=>openethereum/openethereum
parity-zcash=>paritytech/parity-zcash
phala-blockchain=>Phala-Network/phala-blockchain
polkadot=>paritytech/polkadot
rbtc=>lucawen/rbtc
rust-cardano=>input-output-hk/rust-cardano
solana=>solana-labs/solana
substrate=>paritytech/substrate
tendermint-rs=>informalsystems/tendermint-rs
wagyu=>AleoHQ/wagyu
zcash=>zcash/zcash
yeeroot=>yeeco/yeeroot

##Database
indradb=>indradb/indradb
materialize=>MaterializeInc/materialize
noria=>mit-pdos/noria
lucid=>lucid-kv/lucid
parity-db=>paritytech/parity-db
PumpkinDB=>PumpkinDB/PumpkinDB
rsedis=>seppo0010/rsedis
skytable=>skytable/skytable
tikv=>tikv/tikv
sled=>spacejam/sled
terminusdb-store=>terminusdb/terminusdb-store
datafuse=>datafuselabs/datafuse

##Debugging
=>cs01/gdbgui

##Emulators
rust64=>kondrak/rust64
ruffle=>ruffle-rs/ruffle
mooneye-gb=>Gekkio/mooneye-gb
rboy=>mvdnes/rboy
RGB=>nivent/RGB
gameboy=>mohanson/gameboy
rustboyadvance-ng=>michelhe/rustboyadvance-ng
oxidenes=>iamsix/oxidenes
pinky=>koute/pinky
sprocketnes=>pcwalton/sprocketnes
plastic=>Amjad50/plastic
rustzx=>pacmancoder/rustzx
raze=>rodrigorc/raze
rustual-boy=>emu-rs/rustual-boy
i8080=>mohanson/i8080
snesutilities=>ioncodes/snesutilities

##HTTP Client
curl-rust=>alexcrichton/curl-rust
async-graphql=>async-graphql/async-graphql
graphql-client=>graphql-rust/graphql-client
hyper=>hyperium/hyper
reqwest=>seanmonstar/reqwest

##Music & Audio
enginesound=>DasEtwas/enginesound
zrtstr=>indiscipline/zrtstr
lyriek=>bartwillems/lyriek
ncspot=>hrkfdn/ncspot
musinfo=>Phate6660/musinfo
rsmpc=>Phate6660/rsmpc
rsmpc-gui=>Phate6660/rsmpc-gui
rsmpc-gui=>Phate6660/rsmpc-gui
polaris=>agersant/polaris
spotify-tui=>Rigellute/spotify-tui
hspotifyd=>Spotifyd/spotifyd

##Games
euclider=>Limeth/euclider
resvg=>RazrFalcon/resvg
svgbob=>ivanceras/svgbob
svgcleaner=>RazrFalcon/svgcleaner
tray_rust=>Twinklebear/tray_rust
Image-Processing-CLI-in-Rust=>mikigraf/Image-Processing-CLI-in-Rust

##Image Processing
imager=>imager-io/imager
oxipng=>shssoichiro/oxipng

##Industrial Automation
opcua=>locka99/opcua
tokio-modbus=>slowtec/tokio-modbus
modbus-iiot-rust=>BiancoRoyal/modbus-iiot-rust

##Observability
vector=>timberio/vector
gtsa=>Mnwa/gtsa
scaphandre=>hubblo-org/scaphandre

##Operating Systems
nebulet=>nebulet/nebulet
rust_os=>thepowersgang/rust_os
tock=>tock/tock

##Productivity
espanso=>federico-terzi/espanso
pier=>pier-cli/pier
subilo=>Bansco/subilo

##Video
yaydl=>dertuxmalwieder/yaydl
rsmpv=>Phate6660/rsmpv
vidmerger=>tgotwig/vidmerger
rav1e=>xiph/rav1e
slingr=>yuvadm/slingr
streamlib=>streamlib/streamlib


##Virtualization
firecracker=>firecracker-microvm/firecracker
railcar=>oracle/railcar
vagga=>tailhook/vagga
youki=>containers/youki

##Web
Plume=>Plume-org/Plume
lemmy=>LemmyNet/lemmy
