@@@Getting Started

##Basics
RxJava Intro=>intro
Getting Started=>getting_started
How to Use RxJava=>how_to_use_rxjava

@@@Streams

##Reactive Streams
Reactive streams=>reactive_streams

##Observable
Observable Tutorial=>observable

@@@Scheduler

##Scheduler
Scheduler Tutorial=>scheduler

@@@Subject

##Subject
Subject Tutorial=>subject

@@@Error Handling

##Error
Error Handling=>error_handling

@@@Operators

##Operators
Async=>async_operators
Blocking=>blocking_observable_operators
Combining=>combining_observables
Conditional & Boolean=>conditional_and_boolean_operators
Connectable=>connectable
Creation=>creating_observables
Error management=>error_handling_operators
Filtering=>filtering_observables
Mathematical and Aggregate=>mathematical_and_aggregate_operators
Parallel flows=>parallel_flows
String=>string_observables
Transformation=>transforming_observables
Utility=>observable_utility_operators
Operator matrix=>operator_matrix



